map.png
30 20
0  1  0  1  0  1  0  1  0  1  0  1  0  1  0  1  0  1  0  1  0  1 63 63  0  1  0  1  0  1
8  9  8  9  8  9  8  9  8  9  8  9  8  9  8  9  8  9  8  9  8  9 10 10  8  9  8  9  8  9
0  1 10 10 10 10 10 10 10 10 10 10 10 10 10 10 10 10 10 10 10 62 10 10 62 10 10 10  0  1
8  9 10 10 10 10 20 20 10 10 10 10 10 20 20 10 10 10 10 10 10 10 10 10 10 10 10 10  8  9
0  1 10 10 10 19  0  1 20 10 10 10 20 63 62 20 10 10 10 10 19 19 10 10 10 10 10 10  0  1
8  9 10 10 10 19  8  9 20 10 10 10 20 20 63 20 10 10 10 19  0  1 19 10 10 10 10 10  8  9
0  1 10 10 10 10 19 19 10 10 10 10 10 20 20 10 10 10 10 19  8  9 19 10 10 10 10 10  0  1
8  9 10 10 10 10 10 10 10 20 20 10 10 10 10 10 10 19 19 10 19 19 10 19 19 10 10 10  8  9
0  1 10 10 10 10 10 10 20  0  1 19 10 10 10 10 19  0  1 19 10 10 19  0  1 19 10 10  0  1
8  9 10 10 10 10 10 10 20  8  9 19 10 10 10 10 19  8  9 19 10 10 19  8  9 19 10 10  8  9
0  1 10 10 10 10 10 10 10 19 19 10 10 10 10 10 10 19 19 10 10 10 10 19 19 10 10 10  0  1
8  9 10 10 10 10 10 10 10 10 10 10 10 10 10 10 10 10 10 62 63 63 62 10 10 10 10 10  8  9
0  1 10 10 10 10 10 10 10 10 10 10 10 10 10 10 10 10 10 63 62 62 63 10 10 10 10 10  0  1
8  9 10 10 10 10 10 10 10 20 19 19 20 10 10 10 10 10 10 63 62 62 63 10 10 10 10 10  8  9
0  1 10 10 10 10 10 10 10 19 63 62 19 10 10 10 10 10 10 63 62 62 63 10 10 10 10 10  0  1
8  9 10 10 10 10 10 10 10 19 63 63 19 10 10 10 10 10 10 63 62 62 63 10 10 10 10 10  8  9
0  1 10 10 10 10 10 10 10 20 19 19 20 10 10 10 10 10 10 20 19 19 20 10 10 10 10 10  0  1
8  9 10 63 10 10 63 10 10 10 10 10 10 10 10 10 10 10 10 10 10 10 10 10 10 10 10 10  8  9
0  1  0  1 10 10  0  1  0  1  0  1  0  1  0  1  0  1  0  1  0  1  0  1  0  1  0  1  0  1
8  9  8  9 57 57  8  9  8  9  8  9  8  9  8  9  8  9  8  9  8  9  8  9  8  9  8  9  8  9

