map.png
20 20
0  1  0  1 55 55  0  1  0  1  0  1  0  1  0  1  0  1  0  1
8  9  8  9 20 20  8  9  8  9  8  9  8  9  8  9  8  9  8  9
0  1 62 63 10 10 63 10 10 10 10 10 10 10 10 10 10 62  0  1
8  9 10 10 10 10 63 10 10 10 10 10 10 10 10 10 10 10  8  9
0  1 10 10 10 10 63 10 10 63 63 63 63 63 63 63 10 10  0  1
8  9 10 10 63 63 63 10 10 63 20 19 19 10 10 63 10 10  8  9
0  1 10 10 63 10 10 10 10 63 19  0  1 19 10 63 10 10  0  1
8  9 10 10 63 10  0  1 10 63 19  8  9 19 10 63 10 10  8  9
0  1 10 10 10 10  8  9 10 63 10 19 19 10 10 10 10 10  0  1
8  9 10 10 10 10 10 10 10 63 10 10 10 10 10 10 10 10  8  9
0  1 63 63 63 63 63 63 63 63 10 10 19 19 10 63 10 10  0  1
8  9 10 10 10 10 10 10 10 10 10 19  0  1 19 63 10 10  8  9
0  1 10 10 63 63 63 63 10 10 10 19  8  9 19 10 10 10  0  1
8  9 10 10 10 10 10 10 10 10 10 10 19 19 10 10 10 10  8  9
0  1 10 63 63 63 63 10 10 63 10 10 10 10 10 63 10 10  0  1
8  9 10 63 10 10 10 10 10 63 10 10 63 62 10 10 10 10  8  9
0  1 10 63 10 10 10 10 10 63 10 10 62 63 10 10 10 10  0  1
8  9 20 63 10 10 63 10 10 63 10 10 10 10 10 63 62 62  8  9
0  1  0  1 19 19  0  1  0  1  0  1  0  1  0  1  0  1  0  1
8  9  8  9 40 42  8  9  8  9  8  9  8  9  8  9  8  9  8  9

